besonders		particularly
sondern			but
sicher			sure
sicher			safe
wahrscheinlich		probably
die Skizze		sketch
skizzen			to sketch
die Badewanne		bathtub
der Bericht		report
nennt man		is called
das Gebäude		building
aufgeräumt		tidied
aufräumen		to tidy up
bei			at
beim			when
der Vergangenheit	the past
die Zukunft		the future
das Vorliegende		the present
der Anrufbeantworter	answering machine
die Nachricht		message
hinterlassen		to leave a message
der Kellner		waiter
tätig			active
die Tätigkeit		activity
verteilen		to distribute
passen			to suit
verpassen		to miss 
aufpassen		to look out
anstrengend		exhausting
verdienen		to earn
erledigen		to take care of
holen			to get
abholen			to collect
die Aufgabe		task
Hausaufgaben		homework
speichern		to save
zusätzliche		additional
kontrollieren		to check
überprüfen		to check
ankündigen		to announce
unterdessen		meanwhile
mittlerweile		meanwhile
inzwischen		meanwhile
männlich		masculine
weiblich		feminine
sächlich		neuter
mehrzahl		plural
laufen			to run, to function
laufen			to function
anlaufen		to start off
herumlaufen		to walk around
fangen			to catch
anfangen		to start
gefangen		to capture
der Umfang		scope
die Bedingung		condition
das Befinden		condition
der Zustand		condition
die Fortsetzung		continuation
die Lösung		solution
die Auflösung		solution
kommen			to come
vorkommen		to occur
der Mangel		a lack of something
betreuen		to look after
betreuen		to be accustomed to
fest			fixed
Teilzeit		part time
erlauben		to allow
die Betreuung		care
die Einstellung		setting
ändern			to change
geändert		changed
die Mehrheit		majority
die Minderheit		minority
der Durchschnitt	average
der Mittelwert		average
vornehmen		to carry out
schätzen		to estimate
die Handlung		the act
regelmäßig		regular
Gemeinschaft		community
fördern			to promote
leisten			to achieve
das Opfer		victim
unterstützen		to support
die Maßname		measure
die Bildung		education
die Forderung		requirement
die Herausforderung	challenge
bereit			ready
bereits			already
bereiten		to prepare
vorbereiten		to prepare
kaum			hardly
trotz			despite
trotzdem		nevertheless
die Beziehung		relationship
beziehen		to obtain
fast			almost
vorstellen		to introduce
sich etw vorstellen	to imagine something
stellen			to put
gewöhnlich		usually
mehrere			several
genannt			called
entstehen		to emerge
eng 			close
die Wirtschaft		economy
die Wissenschaft	science
die Mannschaft		team
die Gemeinschaft	comunity
die Gesellschaft	society
die Eigenschaft		characteristic
die Gegnerschaft	opposition
die Landschaft		landscape
die Leidenschaft	passion
die Ortschaft		place
die Bereitschaft	willingness
günstig			low-priced
günstig			convenient
günstig			favourable
halten			to hold
einhalten		to follow
bestimmte		certain
der Erfolg		result
niedrig			low
wachsen			to grow
zweistelligen		double digit
die Tatsache		fact
erwarten		to expect
zutreffen		to apply
ersetzen		to replace
die Beliebheit		popularity
die Gewohnheit		habit
das Gespräch		conversation
äußern			to express
die Zweckentfremden	misuse
vorsehen		to provide
ausreichend		sufficient
unzureichend		insufficient
allerdings		although
obwohl			although
wohl			well
sowohl			both
der Übergang		transition
verzögern		to delay
das Gesetz		the law
bezüglich		concerning
bewegt			moves
wegen			because of
ermöglichen		to enable
statt			instead of
stattfinden		to take place
die Beschreibung	description
der Zustand		condition
der Ausbau		building extension
sogar			even
meiden			to avoid
wegen			because of
deswegen		because of this
umgekehrt		vice versa
übrigens		by the way, incidentally
drängend		urgent
dringend		urgent
die Veranstaltung	event
abnehmen		to remove
abnehmen		to decrease
zunehmen		to increase
die Dauer		duration
Dauersperrung		permanent closure
die Umfrage		survey
gering			small
niedrig			small
das Gesetz		law
das Recht		law
die Rechtsordnung	law
das Gericht		court of law
vorstellen		to introduce
deutlich		clearly
die Behandlung		treatment
der Zeitraum		period of time
herstellen		to produce
greifen			to catch
die Frist		term 
kurzfristig		short term
die Fähigkeit		ability
die Leistung		performance
die Leistungfähigkeit	efficiency
das Zeug		stuff
der Alltag		everyday life
die Fachsleute		professionals
der Bericht		report
der Fortschritt		advance, progress
voranbringen		to advance
beziehen auf		in relation to 
messen			to measure
vorn			in front
erschreckend		frightening
ehrlich			honest
die Ehrlichkeit		honesty
geschehen		to happen
vorkommen		to happen
begegnen		to happen
passieren		to happen
verschwinden		to disappear
verschwinden lassen	to wipe out
wiederbekommen		to regain
der Täter		perpetrator
die Wirkung		effect
due Auswirkung		effect
wirken			to act
untersuchen		to investigate
das Gift		poison
das Rauschgift		drug
breiten			spread
ausbreiten		spread
verbreiten		spread
schädlich		harmful
anregen			to stimulate
die Ursache		cause
verursachen		to cause
bewirken		to cause
veranlassen		to cause
das Auftreten		occurrence
das Vorkommen		occurrence
auftreten		to occur
erfolgen		to occur
vorkommen		to occur
das Gehirn		brain
das Hirn		brain
der Verstand		mind
der Verstand		sense
der Verstand		understanding
offenbar		apparently
offenbaren		to reveal
erhalten		to receive
empfangen		to receive
demnächst		next
auflösen		to dissolve
sich auflösen		to break up
zersetzen		to decompose
finster			dark
böse			evil
schweigen		to remain silent
verstummt		to fall silent
radieren		to erase
der Zwilling		twin
die Berechnung		calculation
die Regung		movement
auslösen		to set off
erfahren		to learn
die Erfahrung		experience
die Erwähnung		mention
vor allem		particularly
raunen			to whisper
der Anspruch		claim
bei			at, in, with
entlassen		to dismiss
verwerfen		to dismiss
abtun			to dismiss
genauso			just as
sich gewöhnen		get used to
die Demütigung		humiliation
bestehen in 		consists of
lächeln			to smile
lachen			to laugh
der Hohn		scorn
höhnisch		scornful
verächtlich		scornful
knipsen			to snap a picture
eng			close
winzig			tiny
einzig			only
die Behörden		authorities
die Sehnsucht		longing
ungeheuer		enormous
ergründen		to fathom
verbergen		to hide
verstecken		to hide
verschweigen		to hide
darum			therefore
bemerken		to notice
beachten		to notice
beobachten		to observe
überwachen		to observe
verdorben		spoiled
die Mühe		effort
mühelos			easily
eher			rather
drängen			to urge
sich zeigen		to appear
die Pein		anguish
die Qual		anguish
peinlich		embarrassing
die Peinlichkeit	embarassment
schaffen		to establish
zumindest		at least
mindestens		at least
die Einigung		agreement
zwar			indeed
tatsächlich		indeed
stimmen			to vote
zustimmen		to agree
abstimmen		to agree
der Vorschlag		proposal
betreiben		to operate
verplant		scheduled
der Vertrag		contract
versiegeln		to seal
ertragen		to endure
erträglich		bearable
ablehnen		to reject
deutlich		clear
inzwischen		in the meantime
künftig			future
salopp			sloppy
schlampig		sloppy
nachlässig		carelessly
der Ausschuss		committee
entlassen		to relieve
zuständig		responsible
verantwortlich		responsible
schikanieren		to bully
belästigen		to bully
vermuten		to suspect
angelegenheit		matter, issue
offensichtlich		obviously
dicht			close
der Konkurs		failure
der Konkurs		bankruptcy
der Bankrott		bankruptcy
die Pleite		collapse
die Gewissheit		certainty
die Ungewissheit	uncertainty
ausschließen		to exclude
das Verbrechen		crime
üppig			luxuriant
umfassen		to include
notwendig		necessary
der Abriss		demolition
die Entscheidung	decision
enthalten		to contain
allgemain		generally
das Strecken		stretch
sanfte			gentle
schweigen		to be silent
verabreden		to arrange
sich verabreden		to arrange to meet
beinahe			almost
drehen			to turn
bröckeln		to crumble
fort			away
fortführen		to continue
der Absatz		sales
der Absatz		paragraph
der Absatz		heel
erschienen		to appear
schlucken		to swallow
der Zweifel		doubt
das Gerücht		rumour
ablegen			to store
erkennen		to recognise
hinauf			up
einholen		to catch up
seufzen			to sigh
leise			soft
gleißen			to gleam
andeuten		to indicate
die Erforschung		research
der Bestandteil		component
senken			to reduce
der Blutdruck		blood pressure
hingegen		however
landläufig		commonly
wirksam			effective
bevorzugen		to prefer
andeuten		to suggest
die Rezension		review
angenehm		enjoyable
die Decke		blanket
sich beeilen		to hurry
gähnen			to yawn
torkeln			to stagger
tauchen			to immerse
kahl			bare
schmal			narrow
eng			narrow
die Lichtung		clearing
der Beton		concrete
die Ferne		distance
mittelmäßig		mediocre
der Erfolg		success